F 220,130,0

NO ./path_to_the_north_texture

SO ./path_to_the_south_texture

WE ./path_to_the_west_texture

EA ./path_to_the_east_texture

C 255,30,33

11111111111
10000000001
10000000001
10000000001
10000000001
10000000001
10000000001
10000W00001
11111111111