F 220,130,0

NO ./path_to_the_north_texture

SO ./path_to_the_south_texture

WE ./path_to_the_west_texture

EA ./path_to_the_east_texture

C 255,30,33

11111111111111111
10100111111111111
10110100000001111
100110000N1011111
11111111111110001
11111111111111111