F 220,130,0

NO ./path_to_the_north_texture

SO ./path_to_the_south_texture

WE ./path_to_the_west_texture

EA ./path_to_the_east_texture

C 255,30,33

1111111111111111111111111
1000000000000000000000001
1000000000000000000000001
100000000W000000000000001
1000000000000000000000001
1000000000000000010000001
1000000000000000000000001
1000000000000000000000001
1000000000000000000000001
1000000000000000000000001
1000000000000000000000001
1111111111111111111111111