F 220,130,0

NO ./path_to_the_north_texture

SO ./path_to_the_south_texture

WE ./path_to_the_west_texture

EA ./path_to_the_east_texture

C 255,30,33

111111111111111111
100000000000000001
100000000000000001
100000000000000001
100000000000000001
100000000000000001
100000000000000001
100000000000001111
101101000000011
100110000N1011111
1111 111111110001
          1111111