F 74,78,105

NO ./textures/bark.xpm

SO ./textures/bricks.xpm

WE ./textures/walkstone.xpm

EA ./textures/woolsnow.xpm

C 25,30,33


1111111111111111
10W0000000000101
1000010000000101
1011100010010101
1000011011010101
1000010000110101
1000010001000001
1110110001111101
1000000000000001
1111111111111111