F 22,130,0

NO ./textures/kyle-edmonds-stone-path-texture.xpm

SO ./textures/bricks.xpm

WE ./textures/walkstone.xpm

EA ./textures/woolsnow.xpm

C 25,30,33


1111111111111111
10W0000000000101
1000010000000101
1011100010010101
1000011011010101
1000010000111101
1000010001000001
1111110001111101
1000000000000001
1111111111111111