F 220,130,0

NO ./path_to_the_north_texture

SO ./path_to_the_south_texture

WE ./path_to_the_west_texture

EA ./path_to_the_east_texture

C 255,30,33


1111111111111111
1000000000000101
1001010000000101
1011100010010101
1000010001010101
1000000N01111101
1000000000000001
1111110000111101
1000000000000001
1111111111111111