F 255,130,0

NO ./textures/kyle-edmonds-stone-path-texture.xpm

SO ./textures/stone.xpm

WE ./textures/walkstone.xpm

EA ./textures/woolsnow.xpm


C  20,30,33

111111111
 1
1N1
 1
