
SO ./assets/sand.xpm
WE ./assets/stone.xpm
EA  ./assets/wood.xpm



F 220,100,0
C 225,30,0

            1111111111111
            1000000000111
1111111111111000010000011
1001000000000000000000001
1111111110110000011100001111111
100000000011000001110111111111111
11110111111111011100000010001
11110111111111011101010010001
11000000110101011100000010001
10001000000000N01100000010001
10000000000000001101010010001
1100011111110101111111000000111
11110111 1110101 101111010001
11111111 1111111 111111111111